0 0 0 X 0 0 0 0 0 X 0 0 0 0 0 0 0 0 0 B
0 0 0 0 0 0 0 0 0 0 0 0 0 0 0 0 0 0 0 B
0 0 0 0 0 0 0 0 0 0 0 0 0 0 0 0 0 0 0 B
0 0 0 0 0 0 0 0 0 0 0 0 0 0 0 0 0 0 0 B
0 0 0 0 0 0 0 0 0 0 0 0 0 0 0 0 0 0 0 B
0 0 0 0 0 0 0 0 0 0 0 0 0 0 0 0 0 X 0 B
0 0 0 0 0 0 0 0 0 0 0 0 0 0 0 0 0 X 0 B
0 0 0 0 0 0 0 0 0 0 0 0 B B B B B B B B
0 0 0 0 0 0 0 0 0 0 0 0 0 0 0 0 0 0 0 0
0 0 0 0 0 0 0 0 0 0 0 0 0 0 0 0 0 0 0 0
0 0 0 0 0 0 0 0 0 0 0 0 0 0 0 0 0 0 0 0
0 0 0 0 0 0 0 0 0 0 0 0 0 0 0 0 0 0 0 0
0 0 0 0 0 0 0 0 0 0 0 0 0 0 0 0 0 0 0 0
0 0 0 0 0 0 0 X 0 0 0 0 0 0 0 0 0 0 0 0
0 0 0 0 0 0 0 0 0 0 0 0 0 0 0 0 0 0 0 0
0 0 0 0 0 0 0 0 0 0 0 0 0 0 0 0 0 0 0 0
B B 0 0 0 0 0 0 0 0 0 0 0 0 0 0 0 0 B B
0 0 0 0 0 0 0 0 0 0 0 0 0 0 0 0 0 0 X 0
0 0 0 0 0 0 0 0 0 0 0 0 0 0 0 0 0 0 0 0
0 0 0 0 0 0 0 0 0 0 0 0 0 0 0 0 0 0 0 0