0 0 0 X 0 0 0 0 0 X B 0 0 0 0 0 0 0 0 0
0 0 0 0 0 0 0 0 0 X B 0 0 0 0 0 0 0 0 0
0 0 0 0 0 0 0 0 0 X B 0 0 0 0 0 0 0 0 0
0 0 0 0 0 0 0 0 0 X B 0 0 0 0 0 0 0 0 0
0 0 0 0 0 0 0 0 0 X B 0 0 0 0 0 0 0 0 0
0 0 0 0 0 0 0 0 0 X B 0 0 0 0 0 0 0 0 0
0 0 0 0 0 0 0 0 0 X B 0 0 0 0 0 0 X 0 0
0 0 0 0 0 0 0 0 0 X B 0 0 0 0 0 0 0 0 0
0 0 0 0 0 0 0 0 0 X 0 0 0 0 0 0 0 0 0 0
0 0 0 0 0 0 0 0 0 X 0 0 0 0 0 0 0 0 0 0
0 0 0 0 0 0 0 0 0 X 0 0 0 0 0 0 0 0 0 0
0 0 0 0 0 0 0 0 0 X 0 0 0 0 0 0 0 0 0 0
0 0 0 0 0 0 0 0 0 X 0 0 0 0 0 0 0 0 0 0
0 0 0 0 0 0 0 X 0 X 0 0 0 0 0 0 0 0 0 0
0 0 0 0 0 0 0 0 0 X 0 0 0 0 0 0 0 0 0 0
0 0 0 0 0 0 0 0 0 X 0 0 0 0 0 0 0 0 0 0
B B 0 0 0 0 0 0 0 X 0 0 0 0 0 0 0 0 B B
0 0 0 0 0 0 0 0 0 X 0 0 0 0 0 0 0 0 X 0
0 0 0 0 0 0 0 0 0 X 0 0 0 0 0 0 0 0 0 0
0 0 0 0 0 0 0 0 0 X 0 0 0 0 0 0 0 0 0 0